border_size=1
usage=map

Aa          , Ai          , Aa          , Ai          , Aa          , Aa          , Ai          , Ai          , Aa          , Aa          , Aa          , Aa          , Aa          , Aa          , Aa          , Ai          , Aa          , Ai          , Aa          , Aa          , Ai          , Aa          , Aa          , Aa          , Ai          , Ai          , Aa          
Ai          , Aa          , Ai          , Ai          , Wo          , Ai          , Aa          , Ai          , Wo          , Aa          , Ai          , Aa          , Wo          , Ai          , Wo          , Aa          , Wo          , Ai          , Wo          , Aa          , Wo          , Ai          , Aa          , Aa          , Aa          , Aa          , Ai          
Aa          , Ai          , Aa          , Wo          , Ai          , Wo          , Ai          , Wo          , Wo          , Aa          , Wo          , Wo          , Wo          , Wo          , Wo          , Ai          , Wo          , Ai          , Ai          , Wo          , Wo          , Wo          , Aa          , Aa          , Ai          , Aa          , Ai          
Ai          , Ai          , Wo          , Wo          , Wo          , Wo          , Wo          , Ai          , Ww          , Ai          , Wo          , Wo          , Ww          , Wo          , Ww          , Wo          , Wo          , Wo          , Ww          , Wo          , Ai          , Aa          , Wo          , Wo          , Aa          , Aa          , Aa          
Wo          , Ai          , Aa          , Wo          , Wo          , Wo          , Ww          , Ww          , Ww          , Ww          , Ww          , Ww          , Ww          , Ww          , Ww          , Ww          , Ww          , Ww          , Ww          , Ww          , Ww          , Ai          , Wo          , Ai          , Wo          , Wo          , Aa          
Aa          , Wo          , Aa          , Ai          , Ww          , Ww          , Ww          , Ww          , Re^Vct      , Wwr         , Wwr         , Ww          , Mm^Xm       , Mm^Xm       , Mm^Vhh      , Ww          , Wwr         , Wwr         , Gg^Vh       , Ww          , Ww          , Ww          , Ww          , Wo          , Wo          , Aa          , Wo          
Aa          , Wo          , Ww          , Ww          , Ww          , Ww          , Gg          , Re          , Re^Gvs      , Gg          , Gg          , Gg          , Hh          , Mm^Xm       , Mm^Xm       , Gg          , Gg          , Gg          , Re^Gvs      , Rd          , Gg          , Ww          , Ww          , Ww          , Ww          , Ai          , Wo          
Ai          , Wo          , Ww^Vm       , Ww          , Ce          , Ss^Vm       , Gg          , Gg          , Gg          , Re^Gvs      , Gg          , Gg          , Ggf         , Mm^Xm       , Ggf         , Gg          , Gg          , Gg          , Gg          , Re^Gvs      , Gg          , Ds          , Ce          , Ww          , Ww^Vm       , Wo          , Wo          
Wo          , Wo          , Ww          , 4 Ke        , Ce          , Ss          , Gg          , Gg          , Gg          , Gg          , Gg          , Gg          , Gg          , Mm^Xm       , Gg          , Gg          , Gg          , Gg          , Gg          , Gg          , Gg          , Ss          , Ce          , 3 Ke        , Ww          , Wo          , Wo          
Wo          , Wo          , Ww          , Ce          , Ss          , Ss^Bw\      , Rd          , Gg          , Rd          , Rd          , Rd          , Gg          , Gg          , Hh          , Hh^Vc       , Gg          , Gg          , Gg          , Gg          , Gg          , Rd          , Ss^Bw/      , Ss          , Ce          , Ww          , Wo          , Wo          
Wo          , Wo          , Ww          , Ds          , Gg          , Gg          , Gg          , Rd          , Gg          , Gg          , Gg          , Rd          , Gg          , Gg          , Hh          , Gg          , Gs^Fms      , Gs^Fms      , Gg          , Rd          , Gg          , Gg          , Gg          , Ss^Vhs      , Ww          , Wo          , Wo          
Wo          , Wo          , Ww          , Gg          , Gg          , Gg          , Gg          , Gg          , Gg          , Gs^Fms      , Gs^Fms      , Rd          , Rd          , Gg          , Rd          , Hh          , Gg          , Gg          , Rd          , Rd          , Gg          , Gg          , Gg          , Gg          , Ww          , Wo          , Wo          
Wo          , Wo          , Ww          , Gg          , Ggf         , Gg          , Gg          , Gg          , Gg          , Ggf         , Hh          , Gg          , Gg          , Rd          , Wwf^Bw|     , Rd          , Rd          , Rd          , Gg          , Gg          , Gg          , Gg          , Ggf         , Gg          , Ww          , Wo          , Wo          
Wo          , Wo          , Mm^Xm       , Mm^Xm       , Mm^Xm       , Mm^Vc       , Mm^Xm       , Hh          , Hh          , Hh^Vc       , Gg          , Gg          , Wwf         , Ww          , Gg^Ve       , Wwf         , Wwf         , Gg          , Gg          , Gg          , Mm^Xm       , Hh          , Mm^Xm       , Mm^Xm       , Mm^Xm       , Wo          , Wo          
Wo          , Wo          , Ww          , Hh          , Gg          , Mm^Xm       , Gg          , Ggf         , Gg          , Gg          , Rd          , Gg          , Gg          , Wwf         , Wwf^Bw|     , Ww          , Gg          , Gg          , Hh^Vc       , Hh          , Ggf         , Mm^Xm       , Gg          , Mm^Vc       , Ww          , Wo          , Wo          
Wo          , Wo          , Ww          , Gg          , Gg          , Ggf         , Gg          , Gg          , Rd          , Rd          , Gs^Fms      , Rd          , Rd          , Rd          , Rd          , Gg          , Hh          , Hh          , Gg          , Gg          , Gg          , Gg          , Gg          , Ggf         , Ww          , Wo          , Wo          
Wo          , Wo          , Ww          , Gg          , Gg          , Gg          , Gg          , Rd          , Gg          , Gs^Fms      , Ggf         , Hh          , Gg          , Gg          , Rd          , Gg          , Gg          , Gs^Fms      , Gg          , Gg          , Gg          , Gg          , Gg          , Gg          , Ww          , Wo          , Wo          
Wo          , Wo          , Ww          , Ss^Vm       , Ss          , Gg          , Rd          , Rd          , Gg          , Gg          , Gg          , Hh          , Gg          , Gg          , Gg          , Rd          , Gg          , Gs^Fms      , Gg          , Gg          , Rd          , Gg          , Ss          , Ds          , Ww          , Wo          , Wo          
Wo          , Wo          , Ww          , Ce          , Ce          , Ss^Bw/      , Gg          , Gg          , Gg          , Gg          , Gg          , Hh^Vc       , Hh          , Gg          , Gg          , Rd          , Rd          , Gg          , Rd          , Rd          , Gg          , Ss^Bw\      , Ce^Kov      , Ce          , Ww          , Wo          , Wo          
Wo          , Wo          , Ww^Vm       , 1 Ke        , Ce          , Ss          , Gg          , Gg          , Gg          , Gg          , Gg          , Gg          , Ggf         , Mm^Xm       , Gg          , Gg          , Gg          , Rd          , Gg          , Gg          , Re^Gvs      , Ss          , Ce          , 2 Ke        , Ww^Vm       , Wo          , Wo          
Aa          , Wo          , Ww          , Ww          , Ww          , Ds          , Gg          , Re^Gvs      , Re^Gvs      , Gg          , Gg          , Gg          , Mm^Xm       , Mm^Xm       , Hh          , Gg          , Gg          , Gg          , Gg          , Re^Gvs      , Gg          , Ss^Vhs      , Ww          , Ww          , Ww          , Wo          , Wo          
Ai          , Ai          , Wo          , Ww          , Ww          , Ww          , Ww          , Gg          , Rp^Vhc      , Rr          , Wwr         , Gg          , Mm^Vhh      , Mm^Xm       , Mm^Xm       , Gg          , Wwr         , Gg          , Gg^Vo       , Gs^Fp       , Ww          , Ww          , Ww          , Ww          , Wo          , Wo          , Ai          
Aa          , Ai          , Ai          , Wo          , Wo          , Ww          , Ww          , Ww          , Ww          , Ww          , Ww          , Wwr         , Ww          , Mm^Xm       , Ww          , Wwr         , Ww          , Ww          , Ww          , Ww          , Ww          , Ww          , Wo          , Wo          , Ai          , Wo          , Ai          
Aa          , Wo          , Aa          , Wo          , Ai          , Wo          , Wo          , Ww          , Wo          , Ww          , Wo          , Ww          , Ww          , Ww          , Wo          , Ww          , Wo          , Ww          , Ww          , Ww          , Wo          , Wo          , Wo          , Ai          , Ai          , Wo          , Ai          
Aa          , Aa          , Wo          , Ai          , Ai          , Ai          , Wo          , Wo          , Aa          , Aa          , Wo          , Wo          , Wo          , Wo          , Ai          , Wo          , Aa          , Wo          , Ai          , Wo          , Aa          , Ai          , Ai          , Ai          , Ai          , Aa          , Ai          
Ai          , Ai          , Ai          , Aa          , Wo          , Ai          , Aa          , Ai          , Aa          , Ai          , Ai          , Ai          , Ai          , Ai          , Aa          , Ai          , Ai          , Ai          , Wo          , Ai          , Wo          , Aa          , Aa          , Ai          , Ai          , Aa          , Aa          
Ai          , Ai          , Ai          , Aa          , Aa          , Ai          , Aa          , Aa          , Aa          , Ai          , Ai          , Ai          , Ai          , Aa          , Ai          , Aa          , Ai          , Ai          , Ai          , Ai          , Ai          , Aa          , Aa          , Aa          , Ai          , Aa          , Ai          
