border_size=1
usage=map

Xos         , Xos         , Xos         , Xos         , Xos         , Xos         , Xos         , Xos         , Xos         , Xos         , Xos         , Xos         , Xos         , Ww          , Ww          , Ww          , Ww          , Xos         , Xos         , Xos         , Xos         , Gs          , Gs          , Gs          , Gs          , Xos         , Xos         , Xos         , Xos         , Xos         , Xos         , Xos         , Xos         , Xos         
Xos         , Xos         , Xos         , Xos         , Xos         , Xos         , Xos         , Xos         , Xos         , Xos         , Ss^Vhs      , Ss          , Ww          , Ww          , Xos         , Xos         , Ww          , Xos         , Xos         , Xos         , Gs          , Gs          , Gs          , Gs          , Gs          , Gs          , Xos         , Xos         , Xos         , Xos         , Xos         , Xos         , Xos         , Xos         
Xos         , Xos         , Xos         , Xos         , Xos         , Xos         , Xos         , Xos         , Gs^Fds      , Gg          , Chs         , Ss          , Ww          , Xos         , Xos         , Xos         , Ww          , Xos         , Xos         , Xos         , Gs          , Gs          , Co          , Gs          , Gs          , Gs          , Xos         , Xos         , Xos         , Xos         , Xos         , Xos         , Xos         , Xos         
Xos         , Xos         , Xos         , Xos         , Xos         , Xos         , Re^Gvs      , Gs^Fds      , Ch          , Rr^Vd       , 1 Kh        , Chw         , Chw         , Wwf         , Wwf         , Xos         , Ww          , Xos         , Wwf         , Wwf         , Gs          , Gs^Vht      , Ko          , 2 Khr       , Chr         , Hh^Vo       , Mm          , Xos         , Xos         , Xos         , Xos         , Xos         , Xos         , Xos         
Xos         , Xu          , Xu          , Xu          , Xu          , Gg^Wm       , Re^Gvs      , Re^Gvs      , Gg          , Ch          , Ch          , Rp^Vhc      , Gg          , Wwf         , Xos         , Wwf         , Ww          , Wwf         , Xos         , Wwf         , Re          , Co          , Qxu         , Ko          , Ch          , Gs          , Gs          , Hh^Vo       , Xu          , Xos         , Xu          , Xos         , Xu          , Xos         
Xu          , Xu          , Xu          , Xu          , Xu          , Re^Gvs      , Re^Gvs      , Re^Gvs      , Gg          , Gg          , Gg          , Rr          , Rr          , Gg          , Xos         , Xos         , Ww          , Xos         , Xos         , Re          , Re          , Gs          , Gs          , Re          , Gs          , Re          , Re          , Re          , Xu          , Xu          , Xu          , Xu          , Xu          , Xu          
Xu          , Xu          , Xu          , Xu          , Ur          , Gg          , Mm          , Gs^Fds      , Mm          , Gg          , Mm          , Mm          , Cud         , Kud         , Xos         , Ss^Vhs      , Wwr         , Ss^Vhs      , Xos         , Kud         , Cud         , Mm          , Mm          , Re          , Mm          , Gs^Fds      , Mm          , Re          , Ur          , Xu          , Xu          , Xu          , Xu          , Xu          
Xu          , Xu          , Xu          , Xu          , Ur          , Uh          , Xos         , Xos         , Xos         , Gg          , Hh          , Xos         , Cud         , Cud         , Xos         , Ss^Vhs      , Wwr         , Ss^Vhs      , Xos         , Cud         , Cud         , Xos         , Hh          , Re          , Xos         , Xos         , Xos         , Uh          , Ur          , Xu          , Xu          , Xu          , Xu          , Xu          
Xu          , Xu          , Uu          , Qxu^Bs/     , Ur          , Qxu^Bs\     , Uu          , Xos         , Qxu^Bs/     , Gg          , Gg          , Xos         , Cud         , Cud         , Cud         , Xos         , Wwf         , Xos         , Cud         , Cud         , Cud         , Xos         , Gg          , Re          , Qxu^Bs\     , Xos         , Uu          , Qxu^Bs/     , Ur          , Qxu^Bs\     , Uu          , Xu          , Xu          , Xu          
Xu          , Xu          , Uu^Vud      , Qxu         , Qxu^Bs|     , Qxu         , Uu^Vu       , Uu          , Uu          , Uh          , Gg          , Gg          , Gg          , Rp^Vhc      , Rp          , Ds          , Ww          , Ds          , Rp          , Rp^Vhc      , Gg          , Gg          , Re          , Uh          , Uu          , Uu          , Uu^Vud      , Qxu         , Qxu^Bs|     , Qxu         , Uu^Vu       , Xu          , Xu          , Xu          
Xu          , Xu          , Uu          , Uu^Uf       , Ur          , Uh          , Qxu^Bs|     , Qxu         , Uu          , Xos         , Xos         , Hh          , Mm          , Gs^Fds      , Hh^Fds      , Ww^Bw\      , Rr^Vd       , Ww^Bw/      , Hh^Fds      , Gs^Fds      , Mm          , Hh          , Xos         , Xos         , Uu          , Qxu         , Qxu^Bs|     , Uh          , Ur          , Uu^Uf       , Uu          , Xu          , Xu          , Xu          
Xu          , Xu          , Uu^Vu       , Uh          , Qxu^Bs|     , Uu^Uf       , Uu^Vud      , Qxu         , Uu          , Xos         , Gg          , Hh          , Gg          , Gs^Fds      , Rp          , Ww^Bw/      , Ww          , Ww^Bw\      , Rp          , Gs^Fds      , Gg          , Hh          , Ur          , Xos         , Uu          , Qxu         , Uu^Vu       , Uu^Uf       , Qxu^Bs|     , Uh          , Uu^Vud      , Xu          , Xu          , Xu          
Xu          , Xu          , Uu          , Qxu         , Ur          , Qxu         , Uu          , Uu          , Qxu^Bs\     , Uh          , Gg          , Gg          , Cud         , Rp^Vhc      , Cud         , Ds          , Wwf         , Ds          , Cud         , Rp^Vhc      , Cud         , Gg          , Gg          , Uh          , Qxu^Bs/     , Uu          , Uu          , Qxu         , Ur          , Qxu         , Uu          , Xu          , Xu          , Xu          
Xu          , Xu          , Xu          , Qxu^Bs\     , Ur          , Qxu^Bs/     , Xos         , Xos         , Xos         , Gg          , Hh          , Xos         , Cud         , Cud         , Xos         , Xos         , Wwr         , Xos         , Xos         , Cud         , Cud         , Xos         , Hh          , Ur          , Xos         , Xos         , Xos         , Qxu^Bs\     , Ur          , Qxu^Bs/     , Xu          , Xu          , Xu          , Xu          
Xu          , Xu          , Xu          , Xu          , Ur          , Uh          , Mm          , Xos         , Mm          , Gg          , Mm          , Xos         , Cud         , Cud         , Xos         , Ss^Vhs      , Wwr         , Ss^Vhs      , Xos         , Cud         , Cud         , Xos         , Mm          , Ur          , Mm          , Xos         , Mm          , Uh          , Ur          , Xu          , Xu          , Xu          , Xu          , Xu          
Xu          , Xu          , Xu          , Xu          , Xu          , Gg          , Gg          , Hh^Fds      , Gg          , Ggf         , Ggf         , Mm          , Rr          , Kud         , Xos         , Ss^Vhs      , Ww          , Ss^Vhs      , Xos         , Kud         , Ur          , Mm          , Ur          , Ur          , Uu          , Gs^Fds      , Ur          , Ur          , Xu          , Xu          , Xu          , Xu          , Xu          , Xu          
Xos         , Xos         , Xos         , Xu          , Xu          , Gg          , Gg          , Gg          , Cv          , Ggf         , Cv          , Rr          , Ggf         , Xos         , Xos         , Xos         , Ww          , Xos         , Xos         , Xos         , Uu          , Ur          , Cud         , Uu^Vud      , Cud         , Ur          , Ur          , Uu          , Xu          , Xu          , Xu          , Xu          , Xu          , Xu          
Xos         , Xos         , Xos         , Xos         , Xos         , Gs^Fds      , Gs^Fds      , Cv          , Cv          , Gg^Ve       , Cv          , Cv          , Wwf         , Wwf         , Wwf         , Wwf         , Ww          , Wwf         , Wwf         , Wwf         , Wwf         , Uu          , Cud         , Cud         , 4 Kud       , Cud         , Cud         , Uu^Uf       , Xu          , Xu          , Xu          , Xu          , Xu          , Xu          
Xos         , Xos         , Xos         , Xos         , Xos         , Xos         , Hh^Fds      , Gg^Ve       , Gs^Fds      , 3 Kv        , Gs^Fds      , Gg^Ve       , Gs^Fds      , Wwf         , Xos         , Xos         , Ww          , Xos         , Xos         , Wwf         , Xos         , Uu          , Uu^Vu       , Uu^Uf       , Uu          , Uu^Vu       , Xu          , Xu          , Xu          , Xu          , Xu          , Xu          , Xu          , Xu          
Xos         , Xos         , Xos         , Xos         , Xos         , Xos         , Hh^Fds      , Hh^Fds      , Gs^Fds      , Gs^Fds      , Gs^Fds      , Gs^Fds      , Gs^Fds      , Xos         , Xos         , Xos         , Ww          , Xos         , Xos         , Xos         , Qxu         , Uu          , Uu          , Qxu         , Qxu         , Xu          , Xu          , Xu          , Xu          , Xu          , Xu          , Xu          , Xu          , Xu          
Xos         , Xos         , Xos         , Xos         , Xos         , Xos         , Xos         , Gs^Fds      , Gs^Fds      , Gs^Fds      , Gs^Fds      , Gs^Fds      , Gs^Fds      , Xos         , Xos         , Xos         , Ww          , Xos         , Xos         , Xos         , Uu          , Qxu^Bs/     , Qxu         , Qxu^Bs\     , Uu          , Qxu         , Xu          , Xu          , Xu          , Xu          , Xu          , Xu          , Xu          , Xu          
